
C 25,25,50

ANI ./textures/flame1.xpm;./textures/flame2.xpm;./textures/flame3.xpm;

SO ./textures/wall.xpm
NO ./textures/wall.xpm

EA ./textures/wall.xpm

F 130,100,70

WE ./textures/wall.xpm
DR ./textures/t_gungeon_door.xpm
1111111111111111111111111111111111111111111111111111111111111
10000000000D000000000000000AAAAAAA0000000000000000D0000000001
10A00000000D00000000000000A0000000A000000000000000D0000000A01
10000000000D000000000000A00000000000A0000000000000D0000000001
11111111111AA000000AAA00000000000000000AA00000000AA1111111111
10000001000A00000000000000000010000000000000000000A0001000001
10A0000100000000000000000000000000000000000000000000001000A01
1000000100000000000000000000000000000000000000000000001000001
100000AAA0000000000000D000O000O000O000D00000000000000AAA00001
10A0000A0000011110000DA0000O00O00O0000AD00001111000000A000A01
100000000000010001000000000O00O00O000000000100010000000000001
111A00000000010A00000000000OOOOOOO00000000000A01000000000A111
100000000000010001000000000000O000000000000100010000000000001
10A0000000000111100000D0000000O0000000D0000011110000000000A01
100000000000000000000DA00O000000000O00AD000000000000000000001
1111A0000000000000000000000O00O00O0000000000000000000000A1111
1000000000000000A00000000000O0O0O0000000000A00000000000000001
10A0000000000000000000000000000000000000000000000000000000A01
100000000000A000000000D00OO0000000OO00D000000000A000000000001
111111111111A00000000000O00000000000O00000000000A111111111111
100000000000A00000000DA0O00000000000O0AD00000000A000000000001
10A0000000000000000000D0O00OOOOOOO00O0D0000000000000000000A01
100000000000000000000000O00000000000O000000000000000000000001
1AAA11011AA0AA0A0A110DDAOA00ADDDA00AOADD011A0A0AA0AA11011AAA1
111111111111111111111111111111D111111111111111111111111111111
111111111111111111111111111111D111111111111111111111111111111
10000000000D000000000000000AAADAAA0000000000000000D0000000001
10A00000000D00000000000000A0000000A000000000000000D0000000A01
10000000000D000000000000A00000000000A0000000000000D0000000001
11111111111AA000000AAA00000000000000000AA00000000AA1111111111
10000001000A00000000000000000010000000000000000000A0001000001
10A0000100000000000000000000000000000000000000000000001000A01
1000000100000000000000000000000000000000000000000000001000001
100000AAA0000000000000D000O000O000O000D00000000000000AAA00001
10A0000A0000011110000DA0000O00O00O0000AD00001111000000A000A01
100000000000010001000000000O00O00O000000000100010000000000001
111A00000000010A00000000000OOOOOOO00000000000A01000000000A111
100000000000010001000000000000O000000000000100010000000000001
10A0000000000111100000D0000000O0000000D0000011110000000000A01
100000000000000000000DA00O000000000O00AD000000000000000000001
1111A0000000000000000000000O00O00O0000000000000000000000A1111
1000000000000000A00000000000O0O0O0000000000A00000000000000001
10A0000000000000000000000000000000000000000000000000000000A01
100000000000A000000000D00OO0000000OO00D000000000A000000000001
111111111111A00000000000O00000000000O00000000000A111111111111
100000000000A00000000DA0O00000000000O0AD00000000A000000000001
10A0000000000000000000D0O00OOOOOOO00O0D0000000000000000000A01
100000000000000000000000O0000W000000O000000000000000000000001
1AAA11011AA0AA0A0A110DDAOA00ADDDA00AOADD011A0A0AA0AA11011AAA1
1111111111111111111111111111111111111111111111111111111111111
